The farmer behind the bike admires	singular_singular	correct	id148
The farmer behind the bike admire	singular_singular	wrong	id148
The farmer near the chair admires	singular_singular	correct	id177
The farmer near the chair admire	singular_singular	wrong	id177
The father behind the dog avoids	singular_singular	correct	id190
The father behind the dog avoid	singular_singular	wrong	id190
The lawyer near the tree admires	singular_singular	correct	id348
The lawyer near the tree admire	singular_singular	wrong	id348
The lawyer near the truck admires	singular_singular	correct	id350
The lawyer near the truck admire	singular_singular	wrong	id350
The mother behind the dog avoids	singular_singular	correct	id388
The mother behind the dog avoid	singular_singular	wrong	id388
The mother near the bike engages	singular_singular	correct	id410
The mother near the bike engage	singular_singular	wrong	id410
The mother near the truck admires	singular_singular	correct	id416
The mother near the truck admire	singular_singular	wrong	id416
The poet near the window admires	singular_singular	correct	id447
The poet near the window admire	singular_singular	wrong	id447
The uncle near the bike admires	singular_singular	correct	id532
The uncle near the bike admire	singular_singular	wrong	id532
The uncle near the cat avoids	singular_singular	correct	id537
The uncle near the cat avoid	singular_singular	wrong	id537
The victim beside the bike admires	singular_singular	correct	id552
The victim beside the bike admire	singular_singular	wrong	id552
The victim beside the window admires	singular_singular	correct	id562
The victim beside the window admire	singular_singular	wrong	id562
The victim near the dog remembers	singular_singular	correct	id564
The victim near the dog remember	singular_singular	wrong	id564
The victim near the truck admires	singular_singular	correct	id566
The victim near the truck admire	singular_singular	wrong	id566
The aunt beside the cats avoids	singular_plural	correct	id636
The aunt beside the cats avoid	singular_plural	wrong	id636
The aunt near the cars avoids	singular_plural	correct	id641
The aunt near the cars avoid	singular_plural	wrong	id641
The boy behind the bikes understands	singular_plural	correct	id647
The boy behind the bikes understand	singular_plural	wrong	id647
The boy behind the cars approves	singular_plural	correct	id648
The boy behind the cars approve	singular_plural	wrong	id648
The boy behind the chairs admires	singular_plural	correct	id649
The boy behind the chairs admire	singular_plural	wrong	id649
The boy behind the desks admires	singular_plural	correct	id651
The boy behind the desks admire	singular_plural	wrong	id651
The boy beside the bikes understands	singular_plural	correct	id657
The boy beside the bikes understand	singular_plural	wrong	id657
The boy beside the desks avoids	singular_plural	correct	id663
The boy beside the desks avoid	singular_plural	wrong	id663
The boy beside the dogs engages	singular_plural	correct	id665
The boy beside the dogs engage	singular_plural	wrong	id665
The boy near the cats engages	singular_plural	correct	id675
The boy near the cats engage	singular_plural	wrong	id675
The boy near the dogs avoids	singular_plural	correct	id681
The boy near the dogs avoid	singular_plural	wrong	id681
The carpenter near the cars approves	singular_plural	correct	id708
The carpenter near the cars approve	singular_plural	wrong	id708
The doctor behind the bikes avoids	singular_plural	correct	id717
The doctor behind the bikes avoid	singular_plural	wrong	id717
The doctor beside the bikes engages	singular_plural	correct	id725
The doctor beside the bikes engage	singular_plural	wrong	id725
The doctor beside the bikes understands	singular_plural	correct	id726
The doctor beside the bikes understand	singular_plural	wrong	id726
The doctor near the bikes approves	singular_plural	correct	id734
The doctor near the bikes approve	singular_plural	wrong	id734
The doctor near the bikes understands	singular_plural	correct	id736
The doctor near the bikes understand	singular_plural	wrong	id736
The doctor near the cats remembers	singular_plural	correct	id738
The doctor near the cats remember	singular_plural	wrong	id738
The doctor near the dogs avoids	singular_plural	correct	id742
The doctor near the dogs avoid	singular_plural	wrong	id742
The doctor near the trucks remembers	singular_plural	correct	id745
The doctor near the trucks remember	singular_plural	wrong	id745
The farmer behind the cats avoids	singular_plural	correct	id750
The farmer behind the cats avoid	singular_plural	wrong	id750
The farmer beside the desks avoids	singular_plural	correct	id767
The farmer beside the desks avoid	singular_plural	wrong	id767
The farmer near the cars remembers	singular_plural	correct	id778
The farmer near the cars remember	singular_plural	wrong	id778
The farmer near the cats approves	singular_plural	correct	id779
The farmer near the cats approve	singular_plural	wrong	id779
The farmer near the windows engages	singular_plural	correct	id782
The farmer near the windows engage	singular_plural	wrong	id782
The father behind the cars avoids	singular_plural	correct	id784
The father behind the cars avoid	singular_plural	wrong	id784
The father behind the trees engages	singular_plural	correct	id793
The father behind the trees engage	singular_plural	wrong	id793
The father behind the windows engages	singular_plural	correct	id796
The father behind the windows engage	singular_plural	wrong	id796
The father near the cars avoids	singular_plural	correct	id808
The father near the cars avoid	singular_plural	wrong	id808
The friend behind the bikes approves	singular_plural	correct	id811
The friend behind the bikes approve	singular_plural	wrong	id811
The friend behind the tables engages	singular_plural	correct	id817
The friend behind the tables engage	singular_plural	wrong	id817
The girl beside the bikes engages	singular_plural	correct	id853
The girl beside the bikes engage	singular_plural	wrong	id853
The guy behind the cars observes	singular_plural	correct	id872
The guy behind the cars observe	singular_plural	wrong	id872
The guy behind the tables admires	singular_plural	correct	id878
The guy behind the tables admire	singular_plural	wrong	id878
The guy beside the bikes understands	singular_plural	correct	id882
The guy beside the bikes understand	singular_plural	wrong	id882
The guy beside the cats avoids	singular_plural	correct	id883
The guy beside the cats avoid	singular_plural	wrong	id883
The guy beside the windows admires	singular_plural	correct	id892
The guy beside the windows admire	singular_plural	wrong	id892
The guy near the bikes approves	singular_plural	correct	id895
The guy near the bikes approve	singular_plural	wrong	id895
The kid behind the dogs engages	singular_plural	correct	id905
The kid behind the dogs engage	singular_plural	wrong	id905
The kid behind the windows admires	singular_plural	correct	id909
The kid behind the windows admire	singular_plural	wrong	id909
The kid beside the cars understands	singular_plural	correct	id915
The kid beside the cars understand	singular_plural	wrong	id915
The kid near the cats remembers	singular_plural	correct	id928
The kid near the cats remember	singular_plural	wrong	id928
The kid near the dogs remembers	singular_plural	correct	id933
The kid near the dogs remember	singular_plural	wrong	id933
The lawyer near the bikes approves	singular_plural	correct	id959
The lawyer near the bikes approve	singular_plural	wrong	id959
The lawyer near the cars engages	singular_plural	correct	id962
The lawyer near the cars engage	singular_plural	wrong	id962
The man beside the bikes engages	singular_plural	correct	id975
The man beside the bikes engage	singular_plural	wrong	id975
The mother behind the cars avoids	singular_plural	correct	id997
The mother behind the cars avoid	singular_plural	wrong	id997
The mother behind the cars observes	singular_plural	correct	id998
The mother behind the cars observe	singular_plural	wrong	id998
The mother behind the cats engages	singular_plural	correct	id999
The mother behind the cats engage	singular_plural	wrong	id999
The mother beside the bikes observes	singular_plural	correct	id1010
The mother beside the bikes observe	singular_plural	wrong	id1010
The mother beside the tables engages	singular_plural	correct	id1013
The mother beside the tables engage	singular_plural	wrong	id1013
The mother near the bikes observes	singular_plural	correct	id1017
The mother near the bikes observe	singular_plural	wrong	id1017
The mother near the cars approves	singular_plural	correct	id1018
The mother near the cars approve	singular_plural	wrong	id1018
The mother near the trees approves	singular_plural	correct	id1023
The mother near the trees approve	singular_plural	wrong	id1023
The poet beside the cars understands	singular_plural	correct	id1043
The poet beside the cars understand	singular_plural	wrong	id1043
The poet near the dogs understands	singular_plural	correct	id1054
The poet near the dogs understand	singular_plural	wrong	id1054
The singer behind the tables engages	singular_plural	correct	id1074
The singer behind the tables engage	singular_plural	wrong	id1074
The singer near the cats engages	singular_plural	correct	id1092
The singer near the cats engage	singular_plural	wrong	id1092
The uncle beside the cars engages	singular_plural	correct	id1131
The uncle beside the cars engage	singular_plural	wrong	id1131
The uncle near the bikes avoids	singular_plural	correct	id1137
The uncle near the bikes avoid	singular_plural	wrong	id1137
The victim behind the bikes avoids	singular_plural	correct	id1145
The victim behind the bikes avoid	singular_plural	wrong	id1145
The victim behind the dogs approves	singular_plural	correct	id1150
The victim behind the dogs approve	singular_plural	wrong	id1150
The victim behind the trucks approves	singular_plural	correct	id1152
The victim behind the trucks approve	singular_plural	wrong	id1152
The victim beside the bikes admires	singular_plural	correct	id1154
The victim beside the bikes admire	singular_plural	wrong	id1154
The victim beside the bikes engages	singular_plural	correct	id1155
The victim beside the bikes engage	singular_plural	wrong	id1155
The victim beside the cats criticizes	singular_plural	correct	id1156
The victim beside the cats criticize	singular_plural	wrong	id1156
The victim beside the trucks understands	singular_plural	correct	id1165
The victim beside the trucks understand	singular_plural	wrong	id1165
The victim near the cars approves	singular_plural	correct	id1166
The victim near the cars approve	singular_plural	wrong	id1166
The victim near the cats engages	singular_plural	correct	id1167
The victim near the cats engage	singular_plural	wrong	id1167
The athletes behind the car stimulate	plural_singular	correct	id1205
The athletes behind the car stimulates	plural_singular	wrong	id1205
The aunts behind the dog observe	plural_singular	correct	id1246
The aunts behind the dog observes	plural_singular	wrong	id1246
The boys behind the cat confuse	plural_singular	correct	id1280
The boys behind the cat confuses	plural_singular	wrong	id1280
The boys behind the chair approve	plural_singular	correct	id1281
The boys behind the chair approves	plural_singular	wrong	id1281
The carpenters behind the dog know	plural_singular	correct	id1302
The carpenters behind the dog knows	plural_singular	wrong	id1302
The carpenters behind the tree discourage	plural_singular	correct	id1303
The carpenters behind the tree discourages	plural_singular	wrong	id1303
The carpenters behind the truck criticize	plural_singular	correct	id1305
The carpenters behind the truck criticizes	plural_singular	wrong	id1305
The carpenters behind the truck understand	plural_singular	correct	id1306
The carpenters behind the truck understands	plural_singular	wrong	id1306
The doctors behind the chair encourage	plural_singular	correct	id1335
The doctors behind the chair encourages	plural_singular	wrong	id1335
The farmers behind the cat confuse	plural_singular	correct	id1361
The farmers behind the cat confuses	plural_singular	wrong	id1361
The farmers behind the cat greet	plural_singular	correct	id1362
The farmers behind the cat greets	plural_singular	wrong	id1362
The farmers behind the desk discourage	plural_singular	correct	id1364
The farmers behind the desk discourages	plural_singular	wrong	id1364
The farmers behind the truck stimulate	plural_singular	correct	id1368
The farmers behind the truck stimulates	plural_singular	wrong	id1368
The farmers behind the window encourage	plural_singular	correct	id1371
The farmers behind the window encourages	plural_singular	wrong	id1371
The farmers near the desk encourage	plural_singular	correct	id1383
The farmers near the desk encourages	plural_singular	wrong	id1383
The fathers behind the chair confuse	plural_singular	correct	id1395
The fathers behind the chair confuses	plural_singular	wrong	id1395
The fathers beside the bike confuse	plural_singular	correct	id1404
The fathers beside the bike confuses	plural_singular	wrong	id1404
The fathers near the window encourage	plural_singular	correct	id1429
The fathers near the window encourages	plural_singular	wrong	id1429
The friends behind the chair encourage	plural_singular	correct	id1435
The friends behind the chair encourages	plural_singular	wrong	id1435
The girls behind the desk encourage	plural_singular	correct	id1460
The girls behind the desk encourages	plural_singular	wrong	id1460
The girls near the cat encourage	plural_singular	correct	id1478
The girls near the cat encourages	plural_singular	wrong	id1478
The kids behind the table encourage	plural_singular	correct	id1511
The kids behind the table encourages	plural_singular	wrong	id1511
The kids behind the window encourage	plural_singular	correct	id1514
The kids behind the window encourages	plural_singular	wrong	id1514
The kids near the desk encourage	plural_singular	correct	id1525
The kids near the desk encourages	plural_singular	wrong	id1525
The lawyers behind the desk encourage	plural_singular	correct	id1536
The lawyers behind the desk encourages	plural_singular	wrong	id1536
The lawyers behind the table greet	plural_singular	correct	id1540
The lawyers behind the table greets	plural_singular	wrong	id1540
The men behind the cat greet	plural_singular	correct	id1570
The men behind the cat greets	plural_singular	wrong	id1570
The men near the window encourage	plural_singular	correct	id1594
The men near the window encourages	plural_singular	wrong	id1594
The mothers behind the bike stimulate	plural_singular	correct	id1596
The mothers behind the bike stimulates	plural_singular	wrong	id1596
The mothers beside the table encourage	plural_singular	correct	id1612
The mothers beside the table encourages	plural_singular	wrong	id1612
The poets beside the table encourage	plural_singular	correct	id1634
The poets beside the table encourages	plural_singular	wrong	id1634
The uncles behind the tree greet	plural_singular	correct	id1712
The uncles behind the tree greets	plural_singular	wrong	id1712
The uncles beside the bike confuse	plural_singular	correct	id1716
The uncles beside the bike confuses	plural_singular	wrong	id1716
The uncles near the dog know	plural_singular	correct	id1732
The uncles near the dog knows	plural_singular	wrong	id1732
The victims behind the chair greet	plural_singular	correct	id1741
The victims behind the chair greets	plural_singular	wrong	id1741
The victims beside the table greet	plural_singular	correct	id1756
The victims beside the table greets	plural_singular	wrong	id1756
The victims near the table encourage	plural_singular	correct	id1766
The victims near the table encourages	plural_singular	wrong	id1766
The victims near the window greet	plural_singular	correct	id1768
The victims near the window greets	plural_singular	wrong	id1768
The women behind the cat encourage	plural_singular	correct	id1772
The women behind the cat encourages	plural_singular	wrong	id1772
The women behind the cat stimulate	plural_singular	correct	id1775
The women behind the cat stimulates	plural_singular	wrong	id1775
The women behind the tree confuse	plural_singular	correct	id1779
The women behind the tree confuses	plural_singular	wrong	id1779
The athletes behind the chairs stimulate	plural_plural	correct	id1803
The athletes behind the chairs stimulates	plural_plural	wrong	id1803
The boys behind the chairs encourage	plural_plural	correct	id1859
The boys behind the chairs encourages	plural_plural	wrong	id1859
The girls behind the windows greet	plural_plural	correct	id2051
The girls behind the windows greets	plural_plural	wrong	id2051
The kids behind the desks encourage	plural_plural	correct	id2100
The kids behind the desks encourages	plural_plural	wrong	id2100
The lawyers behind the tables inspire	plural_plural	correct	id2128
The lawyers behind the tables inspires	plural_plural	wrong	id2128
The men behind the desks encourage	plural_plural	correct	id2155
The men behind the desks encourages	plural_plural	wrong	id2155
The men behind the windows greet	plural_plural	correct	id2161
The men behind the windows greets	plural_plural	wrong	id2161
The men behind the windows stimulate	plural_plural	correct	id2162
The men behind the windows stimulates	plural_plural	wrong	id2162
The uncles behind the trees greet	plural_plural	correct	id2311
The uncles behind the trees greets	plural_plural	wrong	id2311
The women behind the windows stimulate	plural_plural	correct	id2384
The women behind the windows stimulates	plural_plural	wrong	id2384
